1111111111111111111111111111111111111111
1......................................1
1......................................1
1......................................1
1......................................1
1......................................1
1......................................1
1......11111......11111.....1..........1
1......1..............1........1.......1
1......1..............1........1.......1
1.....................1........1.......1
1.............11...............1.......1
1.............11...............1.......1
1.....................1........1.......1
1......1..............1........1.......1
1......1..............1........1.......1
1......1..............1........1.......1
1......11111......11111........1.......1
1..............................1.......1
1..............................1.......1
1................e.............1.......1
1..............................1.......1
1..............................1.......1
11111111111111...111111111111111.......1
11111111111111...111111111111111.......1
1..............................1.......1
1..............................1.......1
1......p..........e............1.......1
1..............................1.......1
1..............................1.......1
1..............................1.......1
1......11111......11111........1.......1
1......1..............1........1.......1
1......1..............1........1.......1
1.....................1........1.......1
1.............11...............1.......1
1.............11...............1.......1
1.....................1........1.......1
1......1..............1........1.......1
1111111111111111111111111111111111111111